111111111111111
1P00111001110C1
101001010010111
101001010010101
1010C1111100101
101101000000101
101111011111101
1000C00000000E1
111111111111111