111111111111111111111111111111
111111111111111111111111111111
111111111111111111111111111111
1111111PCCCCCCCCCCCCCCCCCCCCC1
1111111111111111C11111111111C1
1111111111111111C11111111111C1
1111111111111111C11111111111C1
1111111111111111C11111111111C1
1111111111111111CCCCCCCCCCCCE1
111111111111111111111111111111